19 18 18 19 18 19 19 19 18 18 18 18 18 18 19 19 18 19 19 18 32 32 32 32 32 32 32 32 32 32 19 19 19 18 18 18 18 19 18 19 19 19 19 18 18 19 19 19 18 18
19 18 19 19 19 19 19 19 18 18 19 19 18 18 19 18 18 32 18 18 32 34 34 34 34 34 34 34 34 32 32 32 32 32 19 18 18 18 19 18 19 18 18 18 19 18 19 19 19 19
19 19 19 19 18 18 19 19 19 18 18 18 19 18 32 32 18 18 19 19 34 34 34 34 34 34 34 34 34 34 34 34 34 32 32 32 19 19 18 19 19 18 19 18 18 18 19 19 19 18
18 18 19 19 19 18 19 18 18 19 19 19 32 32 32 34 19 34 19 34 34 34 34 34 34 34 34 34 17 17 34 34 34 34 34 32 32 32 19 19 18 19 19 18 18 18 18 19 19 18
19 19 18 18 18 19 18 19 19 18 19 32 32 34 34 34 34 19 18 34 17 17 17 34 34 34 34 17 17 17 34 34 17 34 34 34 34 32 32 18 19 18 19 18 19 18 18 19 19 18
19 18 19 19 18 18 18 19 19 32 19 18 18 18 19 19 18 19 34 17 17 34 34 34 34 34 34 34 34 34 34 34 34 17 34 34 34 34 32 32 32 18 18 18 19 18 19 19 19 18
18 18 19 19 19 18 19 19 19 19 19 34 34 34 18 19 34 34 34 34 34 34 34 17 34 34 34 34 34 17 34 17 34 17 34 34 34 34 34 34 32 32 19 18 18 19 18 19 18 18
18 19 19 18 19 19 18 32 32 34 34 34 34 34 34 34 34 34 34 17 34 34 17 17 17 17 34 34 17 17 34 17 17 17 17 34 34 34 34 34 34 32 32 19 18 19 18 18 18 19
19 18 19 19 18 19 32 32 34 34 34 34 34 34 34 34 34 34 34 17 34 34 17 34 34 34 17 17 17 34 34 17 17 34 34 34 34 34 34 34 34 34 32 32 18 18 18 18 19 18
18 19 18 18 18 32 32 34 34 34 34 34 34 34 34 34 34 34 34 17 34 34 34 34 34 17 17 17 34 34 34 17 34 34 34 34 34 34 34 34 34 34 34 32 32 19 19 18 19 18
18 19 19 18 19 32 34 34 34 34 32 32 32 34 34 34 34 34 34 17 34 34 34 34 34 34 34 34 17 17 34 34 34 34 34 34 34 32 32 32 34 34 34 34 32 19 19 19 19 18
18 18 18 19 32 32 34 34 34 34 32 32 37 34 34 34 34 34 34 34 34 17 17 17 17 17 17 34 34 34 17 17 17 34 34 34 34 32 32 32 34 34 34 34 32 32 18 19 18 18
19 18 19 32 32 34 34 34 34 34 32 32 32 34 34 34 34 34 34 34 34 34 34 34 34 34 34 34 34 34 17 17 17 34 34 34 34 32 32 32 34 34 34 34 34 32 32 18 18 19
19 18 18 32 34 34 34 34 34 34 34 34 34 34 34 17 34 34 17 34 34 17 34 34 34 17 17 34 34 34 17 34 17 17 34 34 34 34 34 34 34 34 34 34 34 34 32 19 18 18
19 18 19 19 34 34 34 34 34 34 34 34 34 34 34 17 34 34 17 34 34 17 34 34 17 17 34 34 34 34 34 34 34 34 34 34 34 34 34 34 34 34 34 34 34 34 32 32 18 18
19 18 32 19 19 34 34 34 34 34 34 34 34 34 34 34 17 34 17 34 34 34 34 17 34 34 34 34 34 34 34 17 17 34 34 34 34 34 34 34 34 34 34 34 34 34 34 32 18 18
19 32 32 19 18 34 34 34 34 34 34 34 34 17 34 34 34 34 17 17 34 34 34 34 17 17 34 34 34 34 34 34 34 17 17 17 34 34 34 34 34 17 17 17 34 34 34 32 32 19
19 32 34 18 19 34 34 34 34 34 34 34 34 17 34 34 17 17 34 34 34 34 34 34 34 17 17 17 34 17 34 34 34 34 34 17 17 34 34 34 34 34 34 17 17 34 34 34 32 18
18 32 34 18 18 19 34 17 17 17 34 34 34 17 34 34 17 34 34 34 34 34 34 17 17 17 17 17 17 34 34 34 34 34 34 34 17 17 34 17 34 34 34 34 34 34 34 34 32 18
18 32 19 19 18 18 34 17 34 34 34 34 17 34 34 34 34 34 34 34 17 17 17 34 34 34 34 34 34 34 34 34 34 34 34 34 34 17 17 17 17 17 17 34 34 34 34 34 32 18
32 32 19 19 19 17 34 34 34 34 34 34 17 34 34 34 34 34 34 34 17 34 34 34 34 34 34 34 34 34 34 34 34 34 34 34 34 34 34 34 34 34 34 34 34 34 34 34 32 32
18 18 18 19 34 17 34 34 34 34 34 34 34 17 17 34 34 34 34 34 34 34 34 34 34 34 34 17 34 34 34 34 34 34 34 34 34 34 34 34 34 34 34 34 34 34 34 34 34 32
19 34 34 18 34 17 34 34 17 34 34 34 34 34 34 17 17 17 34 34 34 34 34 17 34 34 17 17 34 34 34 34 17 17 34 34 34 34 34 34 34 34 34 34 34 34 17 17 34 32
18 34 34 18 34 17 34 34 17 34 34 34 34 34 34 34 34 34 34 34 34 34 34 17 17 34 34 34 34 34 34 34 17 17 34 34 34 34 34 34 34 34 34 34 34 34 17 17 34 32
18 19 19 19 34 17 34 34 17 34 34 34 34 34 34 34 34 34 34 34 34 17 17 34 34 17 34 17 17 34 34 34 34 34 17 17 34 34 34 34 34 34 34 34 34 34 34 34 34 32
18 19 34 34 34 17 34 34 17 34 34 34 34 34 34 34 34 34 34 34 34 17 34 34 34 34 34 34 34 34 34 34 34 34 34 34 17 17 34 34 34 34 34 34 34 34 34 34 34 32
32 34 34 34 17 17 34 34 17 34 34 34 17 34 34 34 34 34 34 34 34 34 34 34 34 34 34 34 34 34 34 34 34 34 34 34 34 34 17 34 34 34 34 34 34 34 34 34 34 32
32 34 34 34 17 17 34 34 34 34 34 34 17 34 34 34 34 34 34 17 17 17 17 17 17 17 17 17 17 17 17 17 34 34 34 34 34 34 34 17 34 34 17 34 34 34 34 34 34 32
32 34 34 34 34 34 34 34 17 34 34 34 17 34 34 34 34 34 34 17 34 17 17 17 17 17 17 34 34 34 34 34 34 34 34 34 34 34 34 34 34 34 17 34 34 34 34 34 34 32
32 32 34 34 34 34 17 17 17 34 34 34 17 17 34 34 34 34 34 17 17 17 34 34 34 34 34 34 34 34 34 34 34 34 34 34 17 34 34 34 34 34 34 34 34 34 34 34 32 32
19 32 34 34 34 34 34 34 34 34 34 34 34 34 34 34 34 34 17 34 34 34 34 34 34 34 34 34 34 34 34 34 34 34 34 17 17 34 34 34 34 34 34 34 34 34 34 34 32 18
19 32 34 34 34 34 34 34 34 34 34 34 17 17 34 34 17 17 17 17 34 34 34 17 17 17 17 34 34 34 34 34 34 34 17 17 17 17 17 34 34 34 34 34 34 34 34 34 32 19
19 32 34 34 34 34 34 34 34 34 34 34 34 17 17 34 34 34 34 17 17 34 34 17 34 34 17 17 34 34 34 34 34 34 34 34 34 34 34 34 34 34 34 34 34 34 34 34 32 18
18 32 32 34 34 34 34 17 17 17 17 34 34 34 17 34 34 34 34 34 17 17 34 34 17 17 34 34 34 34 34 34 34 17 34 34 34 34 34 34 34 34 34 34 34 34 34 32 32 19
18 18 32 34 34 34 34 34 34 34 17 34 34 34 34 34 34 34 34 34 34 17 17 34 17 17 17 17 17 34 34 34 34 17 34 34 34 34 34 34 34 34 34 17 17 34 34 32 18 18
18 18 32 32 34 34 34 34 34 34 34 34 34 34 34 34 34 34 34 34 34 34 17 17 34 34 34 34 17 17 17 17 17 34 34 34 34 34 34 17 34 34 34 34 34 34 32 32 18 18
19 19 18 32 34 34 34 34 34 34 34 34 34 34 17 17 34 34 34 34 34 34 34 17 34 34 34 34 34 34 34 34 34 34 34 34 34 34 34 34 34 34 34 34 34 34 32 19 19 18
18 19 19 32 32 34 34 34 34 32 32 32 34 34 17 17 34 34 34 34 34 34 34 34 34 34 34 34 34 17 34 17 17 34 34 34 34 32 32 32 34 34 34 34 34 32 32 19 18 18
18 18 18 19 32 32 34 34 34 32 32 32 34 34 34 17 34 34 34 17 17 34 34 34 34 34 34 17 17 34 17 34 17 17 34 34 34 32 32 32 34 34 34 34 32 32 19 19 18 19
18 19 19 19 18 32 34 34 34 32 32 32 34 17 34 34 34 34 17 17 34 34 34 34 34 17 17 34 34 34 17 34 34 17 34 34 34 32 32 32 34 34 34 34 32 19 18 19 18 19
19 19 18 18 18 32 32 34 34 34 34 34 17 17 34 34 34 34 34 17 17 34 34 17 17 17 34 34 34 34 34 34 34 17 34 34 34 34 18 18 18 18 34 32 32 19 18 19 19 18
18 19 19 18 19 19 32 32 34 34 34 34 17 17 34 34 34 34 34 34 34 17 17 34 34 34 34 34 34 34 34 34 34 34 34 34 34 34 18 19 19 18 32 32 19 18 19 19 19 19
18 19 19 18 19 18 19 32 32 34 34 34 34 34 34 17 34 34 34 34 34 34 34 34 17 17 34 34 34 34 34 34 34 34 34 34 34 18 18 19 19 18 18 32 19 19 18 18 19 18
19 18 18 19 19 19 19 18 32 32 34 34 34 34 34 17 34 34 34 34 34 34 34 17 34 17 17 17 17 17 17 17 34 34 34 34 34 18 19 19 34 18 34 18 18 19 18 18 19 19
19 19 18 18 19 19 18 18 18 32 32 32 34 34 34 17 34 34 34 34 34 17 17 34 34 34 34 34 34 34 34 34 34 34 34 34 34 18 18 18 34 18 32 18 19 18 19 19 19 19
19 19 18 19 18 18 19 19 19 18 19 32 32 34 34 34 34 34 34 34 34 34 34 17 17 17 17 34 34 17 17 34 34 34 34 34 34 32 32 18 34 18 34 19 18 19 18 19 19 18
19 19 18 18 19 19 18 19 18 19 19 18 32 32 32 34 34 34 34 34 34 34 34 34 34 34 34 34 34 34 34 34 34 34 34 32 32 32 19 19 18 32 18 32 18 19 18 18 18 19
18 18 19 19 18 19 19 19 19 19 19 18 19 18 32 32 32 34 34 34 34 34 34 34 34 34 34 34 34 34 34 34 34 32 32 32 18 19 19 32 18 32 19 18 19 19 19 18 19 19
18 19 19 18 19 19 19 18 18 18 19 19 18 19 18 18 32 32 32 32 32 34 34 34 34 34 34 34 34 32 32 32 32 32 18 18 19 19 19 19 18 18 19 18 19 19 18 19 18 19
19 19 18 19 19 18 19 19 19 18 18 19 18 18 19 18 19 18 18 19 32 32 32 32 32 32 32 32 32 32 19 19 18 19 18 18 19 19 19 18 19 19 19 19 19 18 18 19 18 18
