19 19 18 18 18 18 18 19 19 19 19 18 18 18 18 19 19 18 18 19 18 19 19 19 19 18 19 19 18 18 18 18 19 19 19 19 18 18 19 18 18 19 19 18 18 19 18 19 19 19
19 18 19 18 19 18 19 19 19 18 18 19 18 18 19 19 19 19 18 19 19 19 19 18 18 19 19 19 19 19 19 19 18 18 19 18 18 18 19 19 18 18 19 18 18 19 19 18 19 19
19 18 19 19 18 19 19 18 19 18 18 19 19 18 19 18 18 18 18 18 19 18 18 19 19 19 19 19 18 18 19 19 18 18 18 18 18 18 18 18 18 19 18 18 18 19 18 19 18 18
19 18 18 18 18 19 19 19 19 19 19 18 19 18 18 19 18 18 19 18 19 18 19 18 18 18 19 18 19 18 19 18 19 19 19 18 19 18 19 19 18 19 19 18 19 18 18 18 18 18
18 19 18 18 19 18 19 19 18 18 18 18 18 18 18 18 18 19 18 18 19 19 18 19 19 19 18 19 19 19 18 18 18 18 18 19 18 19 18 18 19 19 18 18 19 19 18 18 18 18
19 18 18 19 19 19 18 18 19 19 18 18 19 18 18 18 18 19 18 19 19 19 19 19 19 18 19 19 19 19 18 18 19 18 19 19 19 18 18 19 18 18 18 19 18 18 19 18 19 19
18 18 19 18 18 18 18 19 18 18 19 19 18 19 18 18 19 19 18 19 19 19 19 19 19 18 19 19 18 19 19 18 19 18 19 19 19 18 18 18 19 19 19 19 19 19 19 19 19 19
18 19 19 18 19 18 18 19 18 19 19 19 19 19 18 18 19 19 19 18 19 18 19 18 28 26 26 26 26 26 26 29 19 18 18 18 18 19 18 18 19 19 18 19 19 18 18 19 19 19
18 18 18 18 18 19 18 18 18 19 19 19 18 18 18 18 18 19 18 28 26 26 26 26 27 1 1 1 1 1 1 25 26 26 26 26 26 29 19 19 18 19 18 19 18 18 19 18 18 19
19 19 18 19 19 18 19 19 18 19 19 19 18 19 19 19 28 26 26 27 1 16 16 16 1 1 2 1 1 2 1 1 1 2 1 2 1 25 26 29 19 18 18 18 18 19 18 19 18 18
18 18 19 18 18 19 18 18 19 18 18 18 18 28 26 26 27 2 1 16 16 16 16 16 16 1 2 1 2 2 2 2 1 2 1 2 1 2 2 25 29 18 19 19 18 19 19 18 19 18
18 18 19 19 18 19 19 19 19 19 19 28 26 27 2 2 1 16 16 16 16 16 16 16 16 1 2 1 32 32 32 32 32 32 32 32 32 32 32 32 25 29 18 18 18 18 19 18 18 19
19 19 18 19 18 18 19 18 19 19 28 27 1 1 16 16 16 16 16 16 16 16 16 16 16 16 2 1 32 35 34 34 34 36 34 34 34 34 35 32 2 23 19 19 19 19 19 19 18 19
18 18 18 19 18 19 19 19 19 28 27 1 1 16 16 16 16 16 16 16 16 16 16 16 16 16 16 2 32 34 34 34 34 34 34 34 34 34 34 32 1 23 18 19 19 19 18 19 19 18
18 18 19 18 18 18 19 18 28 27 2 2 1 16 16 16 1 1 16 16 16 16 16 16 16 16 16 1 32 34 34 34 34 34 34 34 34 34 34 32 2 23 18 19 19 18 19 18 19 19
19 18 18 19 19 19 18 19 24 1 2 1 16 16 1 2 33 33 1 16 16 16 16 16 16 16 16 2 32 34 34 34 34 34 34 34 34 34 34 32 2 23 18 18 19 18 18 18 19 18
19 19 19 19 18 18 18 19 24 2 1 2 16 16 1 2 33 33 1 16 16 16 16 16 16 16 16 2 32 34 34 34 34 34 34 34 34 34 34 32 2 23 18 18 19 18 18 19 19 19
18 18 19 18 19 18 18 19 24 2 1 2 16 16 12 10 13 2 1 1 16 16 16 16 16 16 16 2 32 34 34 34 34 34 34 34 34 34 34 32 2 25 29 18 19 19 19 19 19 18
19 19 19 19 19 28 26 26 27 2 2 2 16 16 8 3 7 16 16 16 16 16 16 16 16 16 16 2 32 34 34 34 34 34 34 34 34 34 34 32 1 2 25 29 18 18 19 18 18 19
19 19 19 18 19 24 1 2 1 1 2 2 16 16 8 3 7 16 16 16 16 16 16 16 16 16 16 16 32 34 34 34 34 34 34 34 34 34 34 32 1 1 1 23 18 18 18 18 18 18
18 19 18 19 19 24 2 2 2 1 2 2 16 16 8 3 7 16 16 16 16 16 16 16 16 16 16 16 32 35 34 34 34 34 34 34 34 34 35 32 1 1 1 25 29 19 18 19 19 18
18 19 18 19 19 24 2 1 2 1 2 1 1 2 8 3 7 2 1 2 2 2 16 1 16 2 1 2 32 32 32 32 32 32 32 34 32 32 32 32 1 16 16 1 23 18 18 19 18 18
19 18 19 19 19 24 2 1 2 1 2 16 2 2 8 3 7 1 2 1 1 2 2 1 2 1 1 2 2 2 1 1 1 1 8 3 7 2 1 1 1 16 16 1 23 18 18 19 18 18
19 18 19 19 19 24 16 16 16 16 2 1 2 1 8 3 9 10 10 10 10 10 10 10 10 10 10 10 10 10 10 10 10 10 11 3 7 1 1 16 1 16 16 1 23 19 19 18 19 19
19 19 19 19 19 24 16 16 16 16 16 16 2 1 8 3 3 3 3 3 3 3 3 3 3 3 3 3 3 3 3 3 3 3 3 3 7 2 16 16 1 16 16 2 23 18 19 19 18 19
18 18 19 19 19 24 16 16 16 16 16 16 16 16 14 5 5 5 5 5 5 5 5 6 3 3 3 4 5 5 5 5 5 5 5 5 15 1 16 1 1 16 16 2 25 29 19 19 18 19
19 18 19 19 19 24 16 16 1 2 16 16 16 16 1 2 1 2 2 1 1 1 1 8 3 3 3 7 1 2 1 2 1 2 16 16 16 16 1 1 16 16 16 2 2 23 18 19 19 19
19 18 19 19 18 24 16 1 35 35 2 2 2 16 16 2 2 1 2 1 2 2 2 14 5 6 3 7 2 1 1 2 1 2 2 16 16 2 16 16 16 2 16 2 2 23 19 18 19 19
18 18 19 19 19 24 16 1 2 2 2 1 2 16 16 16 1 2 2 1 2 1 1 2 1 8 3 7 1 2 1 2 1 16 16 16 16 16 16 2 1 1 16 2 1 23 18 19 19 19
18 19 19 19 18 24 16 1 1 2 1 2 16 16 16 16 2 1 2 2 2 2 2 2 2 8 3 7 2 1 2 2 1 1 1 2 1 1 1 1 2 1 2 2 2 23 19 18 19 18
18 18 19 19 18 24 16 16 1 1 3 3 2 16 16 1 2 1 2 1 2 2 1 1 12 11 3 7 2 2 2 32 32 32 32 32 32 32 32 32 32 32 1 2 2 23 19 19 19 19
18 18 19 19 19 24 16 16 1 3 1 1 2 16 16 1 2 1 2 12 10 10 10 10 11 3 3 7 2 2 32 32 2 2 1 1 3 1 1 1 36 32 16 16 16 23 18 18 19 18
19 19 18 19 18 24 16 1 2 2 2 3 2 2 16 16 2 1 2 8 3 3 3 3 3 3 4 15 2 1 32 2 1 2 3 3 1 16 16 2 1 32 32 16 16 23 18 19 18 18
18 19 19 18 28 27 16 1 2 2 3 1 16 16 16 16 16 1 12 11 3 4 5 6 3 4 15 1 1 1 32 1 3 3 3 3 16 16 16 1 1 2 32 16 20 31 18 19 19 19
18 19 18 18 24 1 16 16 1 3 2 3 2 2 16 16 16 10 11 3 3 7 2 8 3 7 1 1 1 2 32 2 1 3 3 16 16 16 2 1 2 2 32 2 23 18 19 19 18 18
19 19 19 19 24 1 16 16 16 1 2 1 3 3 2 3 3 2 3 3 4 15 1 8 3 7 2 2 2 2 32 1 3 3 16 16 16 16 16 16 2 2 32 1 23 19 18 18 19 18
19 18 18 18 24 1 16 16 16 1 2 1 2 1 3 2 5 5 5 5 15 1 2 8 3 7 2 1 1 2 32 2 3 16 16 20 21 22 16 16 16 1 32 1 23 18 19 19 18 19
19 18 18 18 30 22 2 16 1 16 16 16 16 16 16 1 3 16 1 2 2 1 2 8 3 7 2 2 1 2 32 2 1 16 16 23 19 24 16 16 16 1 32 2 23 19 19 18 19 18
19 18 18 19 18 30 22 16 16 16 16 16 16 16 16 16 2 16 1 1 2 2 2 8 3 7 2 2 1 1 32 2 1 16 16 25 26 27 16 16 16 2 32 2 23 18 18 19 19 18
18 18 19 18 19 18 30 22 16 16 16 16 16 16 16 16 16 16 2 1 2 1 1 8 3 7 1 2 1 1 32 2 1 3 3 16 1 2 1 2 3 1 32 2 23 19 18 19 19 19
18 18 19 19 19 18 19 30 21 22 1 2 16 16 16 16 16 2 2 1 2 2 1 8 3 9 10 10 10 10 32 10 11 1 3 3 1 3 3 1 2 2 32 2 23 19 18 19 19 18
18 18 18 18 19 18 19 18 18 30 21 22 2 2 2 1 1 2 2 1 1 1 2 8 3 3 3 3 3 3 3 1 3 3 3 1 1 2 1 2 32 32 32 2 23 19 18 18 18 19
18 19 19 19 19 18 18 18 19 19 18 30 21 22 2 1 2 2 1 1 1 1 2 14 5 5 5 5 5 5 32 5 5 5 1 1 3 1 32 32 32 2 20 21 31 19 19 19 19 19
18 19 19 19 18 18 18 18 18 19 18 18 18 30 22 2 1 2 1 2 1 1 2 1 2 1 2 1 1 16 32 32 32 32 32 32 32 32 32 2 1 2 23 19 18 19 19 18 18 18
19 18 18 18 18 18 19 18 19 18 19 18 19 18 30 22 1 2 1 2 1 1 1 2 1 2 2 1 1 16 16 2 3 4 5 1 1 2 2 1 20 21 31 19 18 18 18 19 18 18
19 18 19 19 19 19 19 19 19 18 19 18 19 19 18 30 21 22 2 2 1 2 1 1 1 2 1 1 2 16 20 21 21 22 1 2 1 1 20 21 31 19 19 19 18 19 19 18 19 19
19 19 18 19 18 18 19 19 19 19 19 18 18 18 18 19 19 30 21 22 2 2 1 2 1 20 21 21 21 21 31 19 19 30 21 21 21 21 31 18 18 19 18 18 19 19 19 18 18 18
18 18 19 18 19 19 19 19 18 18 19 18 18 19 19 18 18 19 19 30 21 21 21 21 21 31 18 19 18 19 18 18 19 18 19 19 19 18 19 19 19 19 18 18 18 18 19 18 18 18
19 19 18 19 19 18 18 18 19 18 19 19 18 19 19 18 19 19 18 19 18 19 19 18 18 19 18 18 18 18 19 18 18 19 18 19 18 18 18 18 18 18 18 19 19 18 19 19 19 18
19 18 18 19 18 19 18 19 19 19 19 19 19 19 19 18 19 18 18 19 18 19 19 19 18 19 18 19 18 18 19 18 18 18 19 18 19 18 18 18 18 19 19 19 18 19 19 18 18 19