32 32 32 32 32 32 32 32 32 32 32 32 32 32 32 32 32 32 32 32 32 32 32 32 32 32 32 32 32 32 32 32 32 32 32 32 32 32 32 32 32 32 32 32 32 32 32 32 32 32
32 32 32 32 32 32 32 32 32 32 32 32 34 34 34 34 34 34 34 34 34 34 34 34 34 34 34 34 34 34 32 34 34 34 34 34 34 34 34 34 34 34 34 34 34 34 34 34 34 32
32 36 34 34 34 34 32 32 32 32 32 32 32 32 32 32 32 34 32 32 32 32 32 32 32 32 32 32 32 32 32 34 32 32 32 32 32 32 32 32 32 32 32 32 32 32 32 32 34 32
32 34 34 34 34 34 34 34 34 34 34 34 34 34 34 32 32 34 32 34 34 34 34 34 34 34 34 34 34 34 34 34 32 32 32 34 34 34 34 34 34 34 34 34 34 34 32 32 34 32
32 34 34 34 34 34 32 32 32 32 32 32 32 32 34 32 32 34 32 34 32 32 32 32 32 32 32 32 32 32 34 34 32 32 32 34 32 32 32 32 32 32 32 32 32 34 32 32 32 32
32 34 34 34 34 34 32 32 32 32 32 32 32 32 34 32 32 34 32 34 32 34 34 34 34 34 32 32 32 32 34 32 32 32 32 34 32 32 32 32 32 32 32 32 32 34 34 34 34 32
32 34 34 34 34 34 32 32 34 34 34 34 34 34 34 34 34 34 32 34 32 34 32 32 32 34 32 32 32 32 34 32 32 32 32 34 32 34 34 34 34 34 34 34 32 34 32 32 34 32
32 32 32 34 32 32 32 32 32 32 32 32 32 32 34 32 32 34 32 34 32 34 32 32 32 34 32 32 32 32 34 32 32 32 32 34 32 34 32 32 34 32 32 34 32 34 32 32 34 32
32 32 32 34 32 32 32 32 32 32 32 32 32 32 34 32 32 34 32 34 32 34 32 34 34 34 34 32 32 32 34 32 32 32 32 34 32 34 32 34 34 34 32 34 32 34 32 32 34 32
32 32 32 34 32 32 32 32 34 34 34 34 34 34 34 32 32 34 32 34 32 34 32 34 34 34 34 34 34 34 34 34 34 34 32 34 32 34 32 34 32 34 32 34 32 34 32 32 34 32
32 32 32 34 32 32 32 34 34 32 32 32 32 32 32 32 32 34 32 34 32 34 32 34 32 32 34 32 32 32 34 32 32 34 32 34 32 34 32 34 32 34 32 32 32 34 32 32 34 32
32 34 34 34 34 34 32 34 32 32 32 32 32 32 34 34 34 34 32 34 32 34 32 34 32 32 34 32 32 32 34 32 32 34 32 34 32 34 32 34 32 34 32 32 32 34 32 32 34 32
32 34 32 32 32 34 32 34 34 34 34 34 34 34 34 32 32 32 32 34 32 34 32 34 32 32 34 32 32 32 34 32 32 34 32 34 32 34 32 34 32 34 34 34 34 34 32 32 34 32
32 34 32 32 32 34 32 34 32 32 32 32 32 32 32 32 32 32 32 34 32 34 32 34 32 32 34 34 34 34 34 32 32 34 32 34 32 34 32 34 32 32 32 32 32 32 32 32 34 32
32 34 32 32 32 34 32 34 34 34 34 34 34 34 34 34 34 34 34 34 32 34 32 34 32 32 34 34 34 34 34 32 32 34 32 34 32 34 32 34 32 34 34 34 34 34 34 34 34 32
32 34 32 32 32 34 32 32 32 32 32 32 32 32 32 32 32 32 32 32 32 34 32 34 32 32 32 34 32 32 34 32 32 34 32 34 32 34 32 34 32 32 32 32 32 32 32 32 32 32
32 34 34 34 34 34 32 32 32 32 32 32 32 32 32 32 32 32 32 32 32 32 32 34 32 32 32 34 32 32 34 32 32 32 32 34 32 34 32 34 34 34 34 34 34 34 34 34 32 32
32 34 34 32 32 34 32 32 32 32 32 32 32 32 32 34 34 34 34 34 34 34 34 34 32 32 32 34 32 32 34 32 32 32 32 34 32 34 32 34 32 32 32 32 32 32 32 34 32 32
32 34 32 32 32 34 34 34 34 34 34 34 34 34 34 34 32 32 32 32 32 32 32 34 34 34 34 34 34 34 34 34 34 34 34 34 32 34 32 34 34 34 32 32 34 32 32 34 32 32
32 34 32 32 32 32 32 32 32 32 32 32 32 32 32 32 32 32 32 32 32 32 32 32 32 32 32 32 32 32 32 32 32 32 32 32 32 32 32 32 32 34 34 34 34 32 34 34 32 32
32 32 32 32 32 32 32 32 32 32 32 32 32 32 32 32 32 32 32 32 32 32 32 32 32 32 32 32 32 32 32 32 32 32 32 32 32 32 32 32 32 32 32 32 32 32 34 32 32 32
32 32 32 34 34 34 34 34 34 34 34 34 34 34 34 34 34 34 34 34 34 34 34 34 34 34 34 34 34 34 34 34 34 34 34 34 34 34 34 34 34 34 34 34 34 34 34 32 32 32
32 32 32 34 32 32 32 32 32 32 32 32 32 32 32 32 32 32 32 32 32 32 34 32 32 32 32 32 32 32 32 32 32 32 32 32 32 32 32 32 32 32 32 32 32 32 34 32 32 32
32 32 32 34 32 32 32 32 32 32 32 32 32 32 32 32 32 32 32 32 32 32 34 32 34 34 34 34 34 34 34 34 34 34 34 34 34 34 34 34 34 34 34 34 34 34 34 32 32 32
32 32 32 34 32 34 34 32 34 34 34 34 34 34 34 34 34 34 34 34 32 32 34 32 34 32 32 32 32 32 32 32 32 32 32 32 32 32 32 32 32 32 32 32 32 32 32 32 32 32
32 34 32 34 32 34 32 32 34 32 32 32 32 32 32 32 32 32 32 34 32 32 34 32 34 34 34 34 34 34 34 34 32 34 34 34 34 34 34 34 34 34 34 34 34 34 34 34 32 32
32 34 32 34 32 34 32 32 34 32 32 32 32 32 32 32 32 32 32 34 32 32 32 32 32 32 32 32 32 32 32 32 32 34 32 32 32 32 32 32 32 32 32 32 32 32 32 34 32 32
32 34 32 34 32 34 32 32 34 34 34 34 32 32 32 32 32 34 32 34 32 32 34 32 34 32 32 32 32 32 34 32 32 34 32 32 32 32 32 32 32 32 32 32 32 32 32 34 32 32
32 34 32 34 32 34 32 32 32 32 32 34 32 32 34 32 32 34 34 34 32 32 34 32 34 32 32 34 32 32 34 32 32 34 32 32 32 32 32 32 32 32 32 32 32 32 32 34 32 32
32 34 32 34 32 34 34 34 34 34 34 34 32 32 34 32 32 34 32 34 32 32 34 32 34 32 32 34 32 32 34 32 32 34 32 32 34 34 34 34 34 34 32 32 32 34 34 34 32 32
32 34 34 34 32 32 32 32 32 32 32 34 32 32 34 32 32 34 32 34 34 34 34 32 34 32 32 34 32 32 34 32 32 34 32 32 34 32 32 32 32 32 32 32 32 34 34 32 32 32
32 34 34 34 32 32 34 34 34 34 34 34 34 34 34 34 32 34 32 34 34 34 34 32 34 32 32 34 32 32 34 32 32 34 32 32 34 32 32 32 32 32 32 32 32 34 32 32 32 32
32 34 34 34 32 32 34 32 32 32 32 32 32 32 32 32 32 34 32 34 32 32 34 32 34 32 32 34 32 32 34 32 32 34 32 32 34 34 34 32 32 32 32 32 32 34 32 32 32 32
32 34 32 34 32 32 34 32 32 32 32 32 32 32 32 32 32 34 32 34 32 32 34 32 34 32 32 34 34 34 34 32 32 34 32 32 32 32 34 34 34 34 34 34 34 34 34 32 32 32
32 34 32 34 34 34 34 34 34 34 34 34 34 34 34 34 34 34 32 34 32 32 34 32 34 32 32 34 32 32 32 32 32 34 32 32 32 32 32 32 32 32 32 32 32 32 34 34 32 32
32 34 32 34 34 34 34 32 32 32 34 32 32 32 32 32 32 32 32 34 32 32 34 32 34 32 32 34 32 32 32 32 32 34 32 32 32 32 32 32 32 32 32 32 32 32 32 34 32 32
32 34 32 34 32 32 34 32 32 32 34 32 32 34 34 34 34 34 34 34 32 32 34 32 34 32 32 34 34 34 34 34 34 34 32 34 34 34 34 34 34 34 34 34 34 32 32 34 32 32
32 34 32 34 32 32 34 32 32 32 34 32 32 34 32 32 32 32 32 32 32 32 34 32 34 32 32 34 32 32 32 32 32 32 32 34 32 32 32 32 34 32 32 32 34 32 32 34 32 32
32 34 32 34 32 32 34 34 34 34 34 32 32 34 32 34 34 34 34 34 34 34 34 32 34 32 32 34 32 32 32 32 32 32 32 34 32 32 32 32 34 34 32 32 34 32 32 34 32 32
32 34 32 34 32 32 32 32 32 32 34 32 32 34 32 34 32 32 32 32 32 32 32 32 34 32 34 34 34 34 34 34 34 32 32 34 32 32 32 32 32 34 32 32 34 32 32 34 32 32
32 34 32 34 32 34 34 34 34 32 34 32 32 34 32 34 34 34 34 34 34 34 34 32 34 32 34 32 32 32 32 32 32 32 32 34 32 32 32 32 32 34 32 32 32 32 32 34 32 32
32 34 32 34 32 34 34 34 34 32 34 32 32 34 32 32 32 32 32 32 32 32 32 32 34 32 34 32 32 32 32 32 32 32 32 34 32 32 32 32 32 34 34 34 34 34 34 34 32 32
32 34 32 34 32 34 32 32 32 32 34 32 32 34 34 34 34 34 34 34 34 34 34 32 34 32 34 32 34 34 34 34 34 34 34 34 32 32 32 32 32 32 32 32 32 32 32 34 32 32
32 34 32 34 32 34 32 32 32 32 34 32 32 32 34 32 32 32 34 32 32 32 34 34 34 32 34 32 34 32 32 32 32 32 32 32 32 32 32 32 32 32 32 32 32 32 32 34 32 32
32 34 32 34 32 34 34 34 34 34 34 32 34 34 34 32 32 32 34 32 32 32 32 32 32 32 34 32 34 32 32 32 32 32 32 32 32 34 34 34 34 36 32 32 32 32 32 34 32 32
32 34 32 34 32 32 32 32 32 32 34 32 34 32 34 32 32 32 32 32 32 32 32 32 32 32 34 32 34 32 32 32 32 32 32 32 32 34 34 34 34 34 32 34 34 34 34 34 32 32
32 34 32 34 34 34 34 34 34 34 34 32 34 32 34 34 34 34 34 34 34 34 34 34 34 34 34 32 34 34 34 34 34 34 34 34 34 34 34 34 34 34 32 34 32 32 32 32 32 32
32 34 32 32 32 34 32 32 32 32 32 32 34 32 32 32 32 32 32 32 32 32 32 32 32 32 32 32 32 32 32 32 32 32 32 32 32 34 34 34 34 34 32 34 32 32 32 32 34 32
32 34 34 34 34 34 34 34 34 34 34 34 34 34 34 34 34 34 34 34 34 34 34 34 34 34 34 34 34 34 34 34 34 34 32 32 32 34 34 34 34 34 32 34 34 34 34 34 34 32
32 32 32 32 32 32 32 32 32 32 32 32 32 32 32 32 32 32 32 32 32 32 32 32 32 32 32 32 32 32 32 32 32 32 32 32 32 32 32 32 32 32 32 32 32 32 32 32 32 32
